########################
#######                #
###                    #
###  ###############   #
###  #  ########   #   S
###  #  ##   ###   #####  
##   #  ##   ###   #####
##   #  ##   ###     ###
##   #####  ####       #
#                      #
############E###########