###############
#             #
#  #  ####### S
#       #######
######       ##
#####  #####  #
#####E#########